01111111111111111111111111111111111111111111111111
01111111111111111111111111111111111111111111111111
01111111111111111111111111111111111111111111111111
01111111111111111111111111111111111111111111111111
01111111111111111111111111111111111111111111111111
01111111111111111111111111111111111111111111111111
01111111111111111111111111111111111111111111111111
01111111111111111111111111111111111111111111111111
01111111111111111111111111111111111111111111111111
01111111111111111111111111111111111111111111111111
01111111111111111111111111111111111111111111111111
01111111111111111111111111111111111111111111111111
01111111111111111111111111111111111111111111111111
01111111111111111111111111111111111111111111111111
01111111100000000011111111111111110000000011111111
01111111000000000001111111111111100000000000111111
01111111000000000000111111111111100000000000011111
01111111100000000001111111111111110000000000111111
01111111110000000011111111111111111100000001111111
01111111111111111111111111111111111111111111111111